(setq grafo '(
           ((4 1) (3 1))
           ((3 1) (3 2))
           ((3 2) (2 2))
           ((2 2) (1 2))
           ((1 2) (1 3))
           ((1 3) (1 4))
           ((3 2) (3 3))
           ((3 3) (3 4))
           ((3 4) (4 4))
           ((4 4) (5 4))
           ((5 4) (6 4))
           ((4 1) (5 1))
           ((5 1) (5 2))
           ((5 2) (6 2))
           ((6 2) (7 2))
           ((7 2) (7 1))
           ((6 2) (6 3))
           ((6 3) (6 4))
           ((6 4) (7 4))
           ((7 4) (7 5))
           ((7 5) (7 6))
           ((7 6) (6 6))
           ((6 6) (5 6))
           ((5 6) (4 6))
           ))
           
